NO textures/wood.xpm
SO textures/wood.xpm
WE textures/wood.xpm
EA textures/wood.xpm
DO textures/wood_door.xpm

F 18,53,25
C 153,204,255

        1111111111111111111111111
        1000000000110000000000001
        1011000001110000000000001
        1001000000000000000000001
111111111011000001110000000000001
100000000011000001112111111111111
11110111111111011100000010001
1111011111111101 101010010001
11000000110101011100000010001
10120022000000001100000020001
10210022000000000000000000001
11000001110101011111011110N0111
11110111 1110101 101111010001
11111111 1111111 111111111111
