NO textures/wood.xpm
SO textures/wood.xpm
WE textures/wood.xpm
EA textures/wood.xpm
DO textures/wood_door.xpm

F 18,53,25
C 153,204,255

        11111111111111		
       11           11
      110           11
     110  11111111  11
	11   1       1  11
   11   1        1  11
  11   1         1  11
 11   1          1  11 
 11   1          1  11        1
 11   111111111111  111111    1
 11                     1111111
 11                     11    1
 11                     1111111
 11111111111111111  111111
                 1  1
                 1  1
                 1  1
                 1  1
                 1111
