NO textures/default/wood.xpm
SO textures/default/wood.xpm
WE textures/default/wood.xpm
EA textures/default/wood.xpm
DO textures/default/wood_door.xpm

F 194,178,128
C 245,248,230

        111111111111        11111111111111
       1100000000011        110000000000011
      11000000000011        1100000000000011
     110001111110011        1111111110000011
    1100011   110011                11000011
   1100011    110011               111000011
  1100011     110011             1110000111
 1100011      110011           1110000111
 1100011      110011         1110000111
 1100011111111110011111    1110000111

 11000000000000000000011111110000111
 110000000000000000000D00W00D000011
 1100000000000000000001111111000011111111111
 1111111111111110011111	    1100000000000011
              110011        1100000000000011
              111111        1111111111111111
